{
    "mapa1":
 		[ "11000000000000000000000000",
		  "0000000000000000000000000",
		  "00000000000000000000000000",
		  "00000000000000000000000000",
		  "00000000000000000000000000",
		  "00000000000000000000000000",
		  "00000000000000000000000000",
		  "11111111111111111111111111",
		  "010000001000000000000000000",
		  "000000001000000000000000",
		  "00000000100000000000000000",
		  "00000000100314000000000000",
		  "222224444444444444444222222222222212121212121212222222222222222222222222222222222222222222222222222222222",
		  "01000000000000000000000000",
		  "00000000000000000000000000",
		  "11111111111111111111111111111111111111111111111111111111111111111111111111"],
			
    "mapa2":
 		[ "00000000000000000000000000",
		  "00000000000000000000000000",
		  "00000000000000000000000000",
		  "00000000000000000000000000",
		  "11111111111111111111111111",
		  "00000000000000000000000000",
		  "00000000000000000000000000",
		  "11111111111111111111111111"],
   "mapa3":
 		[ "00000000000000000000000000",
		  "00000000000000000000000000",
		  "00000000000000000000000000",
		  "00000000000000000000000000",
		  "11111111111111111111111111",
		  "00000000000000000000000000",
		  "00000000000000000000000000",
		  "11111111111111111111111111"],
   "mapa4":
 		[ "00000000000000000000000000",
		  "00000000000000000000000000",
		  "00000000000000000000000000",
		  "00000000000000000000000000",
		  "11111111111111111111111111",
		  "00000000000000000000000000",
		  "00000000000000000000000000",
		  "11111111111111111111111111"],
    "mapa5":
 		[ "00000000000000000000000000",
		  "00000000000000000000000000",
		  "00000000000000000000000000",
		  "00000000000000000000000000",
		  "11111111111111111111111111",
		  "00000000000000000000000000",
		  "00000000000000000000000000",
		  "11111111111111111111111111"],
   "mapa6":
 		[ "00000000000000000000000000",
		  "00000000000000000000000000",
		  "00000000000000000000000000",
		  "00000000000000000000000000",
		  "11111111111111111111111111",
		  "00000000000000000000000000",
		  "00000000000000000000000000",
		  "11111111111111111111111111"]
}
