{
    "mapa1":
 		[ "01000000000010000000000000",
		  "01000000000010000000000000",
		  "11111111111111111111111111",
		  "01000000000010000000000000",
		  "00000000000000000000000000",
		  "01000000000010000000000000",
		  "01000000000010000000000000",
		  "11111111111111111111111111",
		  "01000000000010000000000000",
		  "01000000000010000000000000",
		  "00000000000000000000000000",
		  "01000000000010000000000000",
		  "22222222222222222212121212121212222222222222222222222222222222222222222222222222222222222",
		  "01000000000000000000000000",
		  "00000000000000000000000000",
		  "11111111111111111111111111111111111111111111111111111111111111111111111111"],
			
    "mapa2":
 		[ "00000000000000000000000000",
		  "00000000000000000000000000",
		  "00000000000000000000000000",
		  "00000000000000000000000000",
		  "11111111111111111111111111",
		  "00000000000000000000000000",
		  "00000000000000000000000000",
		  "11111111111111111111111111"],
   "mapa3":
 		[ "00000000000000000000000000",
		  "00000000000000000000000000",
		  "00000000000000000000000000",
		  "00000000000000000000000000",
		  "11111111111111111111111111",
		  "00000000000000000000000000",
		  "00000000000000000000000000",
		  "11111111111111111111111111"],
   "mapa4":
 		[ "00000000000000000000000000",
		  "00000000000000000000000000",
		  "00000000000000000000000000",
		  "00000000000000000000000000",
		  "11111111111111111111111111",
		  "00000000000000000000000000",
		  "00000000000000000000000000",
		  "11111111111111111111111111"],
    "mapa5":
 		[ "00000000000000000000000000",
		  "00000000000000000000000000",
		  "00000000000000000000000000",
		  "00000000000000000000000000",
		  "11111111111111111111111111",
		  "00000000000000000000000000",
		  "00000000000000000000000000",
		  "11111111111111111111111111"],
   "mapa6":
 		[ "00000000000000000000000000",
		  "00000000000000000000000000",
		  "00000000000000000000000000",
		  "00000000000000000000000000",
		  "11111111111111111111111111",
		  "00000000000000000000000000",
		  "00000000000000000000000000",
		  "11111111111111111111111111"]
}
